############
#          #
## ##  # # #
##   # # # #
############